0,0,0,0,0,0,0,0,0,0,0,0,0,0,0 
0,0,0,0,0,0,0,3,0,0,0,0,0,0,0
0,0,0,0,0,0,0,3,0,0,0,0,0,0,0
0,0,3,2,3,2,2,3,0,0,0,0,0,0,0
0,0,2,0,0,0,0,3,0,0,0,0,0,0,0
0,0,2,0,0,0,0,3,0,0,0,0,0,0,0
0,0,2,0,0,0,0,3,0,0,0,0,0,0,0
4,3,1,3,1,3,1,3,1,3,3,1,3,3,5
0,0,0,0,0,0,0,0,0,0,0,0,0,0,0
0,0,0,0,0,0,0,0,0,0,0,0,0,0,0