0,0,0,0,0,0,0,0,0,0,0,0,0,0,0,0,0,0,0,0
0,0,0,0,0,0,0,0,0,0,0,0,0,0,0,0,0,0,0,0
0,0,0,0,0,0,0,0,0,0,0,0,0,0,0,0,0,0,0,0
0,0,3,2,3,2,2,3,0,0,0,0,0,0,0,0,0,0,0,0
0,0,2,0,0,0,0,3,0,0,0,0,0,0,0,0,0,0,0,0
0,0,2,0,0,0,0,3,0,0,0,0,0,0,0,0,0,0,0,0
0,0,2,0,0,0,0,3,0,0,0,0,0,0,0,0,0,0,0,0
5,3,1,3,1,2,1,3,1,3,3,1,3,2,1,1,3,1,3,6
0,0,0,0,0,0,0,0,0,0,0,0,0,0,0,0,0,0,0,0
0,0,0,0,0,0,0,0,0,0,0,0,0,0,0,0,0,0,0,0